........
.BA.....
..F..D..
..EF.B..
...D....
...E....
........
....CAC.
