.BC......
.E.......
..G...D..
..F..AF..
....AD...
.........
.........
.....GB..
.......EC
