C.....D.
........
.C.....D
....A..E
.....E..
.A..F.B.
........
...F...B
