.......DF
.........
..E......
..AE...FC
.......DB
..CA.....
........G
.......B.
.......G.
