.......E.
..A......
..B......
.........
........E
A.D..D...
.BG..F...
...C.G...
C......F.
