D.....AD
...FE.B.
...E..A.
...FC...
..BC....
........
........
........
