.......A
........
..F.....
E...F..A
..E.....
.B...C..
.....D..
B.....CD
