...E.....
...GC.E..
C........
.........
.A..A..G.
D.......F
..D...F..
B........
..B......
